1,1,1,1,1,1,1,1,1,1,1,1,1,1,1,1,1,1,1,1,1,1,1,1,1,1,1,1,1,1,
1,1,1,1,1,1,1,1,1,1,1,1,1,1,1,1,1,1,1,1,1,1,1,1,1,1,1,1,1,1,
1,1,1,1,1,1,1,1,1,1,1,1,1,1,1,1,1,1,1,1,1,1,1,1,1,1,1,1,1,1,
1,1,1,1,1,1,241,242,243,244,1,1,1,1,1,1,1,1,1,1,1,1,1,1,1,1,1,1,1,1,
1,1,1,1,1,241,242,243,244,244,241,242,243,244,1,1,1,1,1,1,1,1,1,1,1,1,1,1,1,1,
1,1,1,1,241,242,243,244,244,274,271,272,273,274,1,1,1,1,1,1,1,1,1,1,1,1,1,1,1,1,
241,241,242,241,242,243,244,244,274,241,242,243,244,1,1,1,1,1,1,76,77,1,1,1,1,1,1,1,1,1,
271,241,241,242,243,244,244,274,274,271,272,273,274,1,1,1,1,76,77,106,107,1,1,1,76,77,1,1,1,1,
241,241,241,241,242,243,244,273,274,241,242,243,98,9,9,100,1,106,107,93,94,94,94,5,106,107,1,1,1,1,
271,271,271,241,241,242,243,244,274,271,272,8,223,129,129,220,100,1,93,97,34,124,124,35,1,1,1,1,1,1,
1,271,272,271,271,272,273,274,274,98,9,223,129,129,129,129,130,1,97,124,124,124,34,35,1,1,1,1,1,1,
1,1,271,272,273,274,274,98,99,223,129,129,129,129,129,190,160,97,124,124,124,124,124,35,1,1,1,1,1,1,
1,1,1,1,76,77,1,128,129,129,129,129,129,129,190,160,97,124,124,124,124,124,66,76,77,1,1,1,1,1,
1,1,1,1,106,107,98,223,129,129,129,129,129,129,130,123,124,124,124,124,124,66,155,106,107,1,1,1,1,1,
1,1,1,1,1,1,128,129,129,129,129,129,129,190,160,97,124,124,124,124,124,125,1,1,1,1,1,1,1,1,
1,1,1,1,1,1,128,129,129,129,129,190,159,160,97,124,124,124,124,124,34,125,1,1,1,1,1,1,1,1,
1,1,1,1,1,1,158,193,129,129,190,160,93,97,124,124,124,124,124,66,154,155,1,1,1,1,1,1,1,1,
1,1,1,1,1,1,1,158,159,159,160,1,123,124,124,124,124,124,66,65,1,1,1,1,1,1,1,1,1,1,
1,1,1,1,1,1,1,1,1,1,76,77,123,124,124,124,124,124,125,1,1,1,1,1,1,1,1,1,1,1,
1,1,1,1,1,1,1,1,1,1,106,107,123,124,124,124,124,66,1,1,1,1,1,1,1,1,1,1,1,1,
1,1,1,1,1,1,1,1,1,1,1,1,123,124,124,124,34,35,1,1,1,1,1,1,1,1,1,1,1,1,
1,1,1,1,1,1,1,1,1,1,1,1,153,67,124,124,66,1,1,1,1,1,1,1,1,1,1,1,1,1,
1,1,1,1,1,1,1,1,1,1,1,1,1,153,154,154,1,1,1,1,1,1,1,1,1,1,1,1,1,1,
1,1,1,1,1,1,1,1,1,1,1,1,1,1,1,1,1,1,1,1,1,1,1,1,1,1,1,1,1,1,
1,1,1,1,1,1,1,1,1,1,1,1,1,1,1,1,1,1,1,1,1,1,1,1,1,1,1,1,1,1,
1,1,1,1,1,1,1,1,1,1,1,1,1,1,1,1,1,1,1,1,1,1,1,1,1,1,1,1,1,1,
1,1,1,1,1,1,1,1,1,1,1,1,1,1,1,1,1,1,1,1,1,1,1,1,1,1,1,1,1,1,
1,1,1,1,1,1,1,1,1,1,1,1,1,1,1,1,1,1,1,1,1,1,1,1,1,1,1,1,1,1,
1,1,1,1,1,1,1,1,1,1,1,1,1,1,1,1,1,1,1,1,1,1,1,1,1,1,1,1,1,1,
1,1,1,1,1,1,1,1,1,1,1,1,1,1,1,1,1,1,1,1,1,1,1,1,1,1,1,1,1,1